{
  "bad": false,
  "new_version": "1.27.0",
  "new_version_attempt_ts": {},
  "new_version_attempts": {
    "1.10.0": 1,
    "1.11.0": 1,
    "1.12.0": 1,
    "1.13.1": 1,
    "1.13.5": 1,
    "1.14.0": 1,
    "1.15.1": 1,
    "1.15.13": 1,
    "1.15.7": 1,
    "1.15.8": 1,
    "1.16.0": 1,
    "1.16.1": 1,
    "1.16.11": 1,
    "1.16.14": 1,
    "1.16.15": 1,
    "1.16.9": 1,
    "1.17.0": 1
  },
  "new_version_errors": {}
}